Team,Season,Date,Location,Opponent,Result,Points_Scored,Opp_points,Pass_Completions,Pass_Attempts,Passing_Pct,Pass_Yards,Pass_TD,Rush_Attempts,Rush_Yards,Rush_Avg,Rush_TD,Total_Plays,Total_Yards,Yards_per_play,Pass_first_downs,Rush_first_downs,Penalty_first_downs,Total_first_downs,Penalties,Penalty_yards,Fumbles,Interceptions,Turnovers
southern-utah,2023,8/31/23,Away,arizona-state,L,21,24,9,18,50,139,1,31,87,2.8,1,49,226,4.6,4,4,2,10,8,71,0,0,0
rhode-island,2023,8/31/23,Away,georgia-state,L,35,42,24,40,60,408,4,35,112,3.2,1,75,520,6.9,13,7,2,22,9,70,0,2,2
south-dakota,2023,8/31/23,Away,missouri,L,10,35,15,25,60,148,1,35,46,1.3,0,60,194,3.2,9,4,1,14,6,57,0,0,0
arkansas-pine-bluff,2023,8/31/23,Away,tulsa,L,7,42,15,26,57.7,150,0,43,102,2.4,1,69,252,3.7,9,8,1,18,4,37,0,1,1
north-carolina-at,2023,8/31/23,Away,alabama-birmingham,L,6,35,2,8,25,16,0,41,147,3.6,0,49,163,3.3,0,10,2,12,2,10,0,0,0
elon,2023,8/31/23,Away,wake-forest,L,17,37,21,36,58.3,147,0,29,104,3.6,1,65,251,3.9,5,7,1,13,4,35,0,2,2
st.-francis-pa,2023,8/31/23,Away,western-michigan,L,17,35,14,24,58.3,230,1,22,51,2.3,1,46,281,6.1,7,4,1,12,6,51,0,0,0
howard,2023,9/1/23,Away,eastern-michigan,L,23,33,16,33,48.5,194,2,42,204,4.9,1,75,398,5.3,7,10,4,21,11,59,0,0,0
missouri-state,2023,9/1/23,Away,kansas,L,17,48,14,21,66.7,143,1,27,74,2.7,1,48,217,4.5,6,3,1,10,6,50,0,2,2
robert-morris,2023,9/2/23,Away,air-force,L,7,42,18,24,75,113,1,26,43,1.7,0,50,156,3.1,4,5,0,9,10,61,2,0,2
gardner-webb,2023,9/2/23,Away,appalachian-state,L,24,45,30,46,65.2,221,1,30,139,4.6,2,76,360,4.7,11,8,0,19,5,50,1,2,3
northern-arizona,2023,9/2/23,Away,arizona,L,3,38,18,29,62.1,186,0,41,78,1.9,0,70,264,3.8,8,3,6,17,11,84,1,0,1
western-carolina,2023,9/2/23,Away,arkansas,L,13,56,25,40,62.5,227,0,30,64,2.1,1,70,291,4.2,10,3,5,18,3,30,1,4,5
south-carolina-state,2023,9/2/23,Away,charlotte,L,3,24,6,17,35.3,59,0,38,109,2.9,0,55,168,3.1,3,4,1,8,6,51,0,1,1
eastern-kentucky,2023,9/2/23,Away,cincinnati,L,13,66,13,25,52,177,1,32,125,3.9,0,57,302,5.3,7,8,0,15,7,42,1,2,3
monmouth,2023,9/2/23,Away,florida-atlantic,L,20,42,26,47,55.3,249,2,36,112,3.1,1,83,361,4.3,13,5,1,19,8,62,0,1,1
maine,2023,9/2/23,Away,florida-international,L,12,14,21,44,47.7,213,0,41,165,4,1,85,378,4.4,14,8,5,27,5,50,1,0,1
tennessee-martin,2023,9/2/23,Away,georgia,L,7,48,18,32,56.3,128,1,30,132,4.4,0,62,260,4.2,7,6,2,15,10,72,0,1,1
citadel,2023,9/2/23,Away,georgia-southern,L,0,34,2,8,25,14,0,43,198,4.6,0,51,212,4.2,0,10,2,12,4,28,1,0,1
northern-iowa,2023,9/2/23,Away,iowa-state,L,9,30,17,35,48.6,173,1,37,106,2.9,0,72,279,3.9,10,7,2,19,6,52,0,2,2
east-tennessee-state,2023,9/2/23,Away,jacksonville-state,L,3,49,10,18,55.6,117,0,38,87,2.3,0,56,204,3.6,5,5,2,12,9,88,2,2,4
bucknell,2023,9/2/23,Away,james-madison,L,3,38,15,23,65.2,146,0,34,62,1.8,0,57,208,3.6,7,2,0,9,7,70,1,0,1
southeast-missouri-state,2023,9/2/23,Away,kansas-state,L,0,45,25,37,67.6,221,0,26,6,0.2,0,63,227,3.6,9,3,1,13,5,65,0,0,0
northwestern-state,2023,9/2/23,Away,louisiana-lafayette,L,13,38,12,28,42.9,110,1,40,77,1.9,0,68,187,2.8,2,5,1,8,7,70,1,0,1
albany,2023,9/2/23,Away,marshall,L,17,21,22,38,57.9,194,1,36,106,2.9,1,74,300,4.1,12,5,2,19,5,47,0,0,0
towson,2023,9/2/23,Away,maryland,L,6,38,16,31,51.6,128,0,34,148,4.4,0,65,276,4.2,6,9,1,16,10,90,0,0,0
bethune-cookman,2023,9/2/23,Away,memphis,L,14,56,13,24,54.2,39,0,24,36,1.5,0,48,75,1.6,1,2,1,4,7,50,1,0,1
southeastern-louisiana,2023,9/2/23,Away,mississippi-state,L,7,48,16,28,57.1,125,1,26,83,3.2,0,54,208,3.9,4,6,0,10,5,25,1,0,1
bryant,2023,9/2/23,Away,nevada-las-vegas,L,14,44,19,31,61.3,230,0,40,179,4.5,2,71,409,5.8,9,10,0,19,6,59,0,1,1
western-illinois,2023,9/2/23,Away,new-mexico-state,L,21,58,16,30,53.3,215,2,28,32,1.1,1,58,247,4.3,11,2,1,14,8,70,0,0,0
tennessee-state,2023,9/2/23,Away,notre-dame,L,3,56,8,22,36.4,67,0,36,89,2.5,0,58,156,2.7,4,5,3,12,5,45,0,2,2
long-island,2023,9/2/23,Away,ohio,L,10,27,21,33,63.6,172,1,22,34,1.5,0,55,206,3.7,7,4,2,13,5,40,0,2,2
central-arkansas,2023,9/2/23,Away,oklahoma-state,L,13,27,24,37,64.9,268,2,28,123,4.4,0,65,391,6,11,7,1,19,9,63,1,0,1
mercer,2023,9/2/23,Away,mississippi,L,7,73,17,31,54.8,142,0,37,93,2.5,1,68,235,3.5,7,6,2,15,7,50,2,1,3
portland-state,2023,9/2/23,Away,oregon,L,7,81,8,20,40,52,1,37,148,4,0,57,200,3.5,3,5,0,8,4,50,1,0,1
wofford,2023,9/2/23,Away,pittsburgh,L,7,45,12,17,70.6,127,1,19,-1,-0.1,0,36,126,3.5,4,1,2,7,2,20,1,0,1
idaho-state,2023,9/2/23,Away,san-diego-state,L,28,36,31,63,49.2,322,2,17,22,1.3,1,80,344,4.3,12,6,6,24,6,50,0,3,3
alcorn-state,2023,9/2/23,Away,southern-mississippi,L,14,40,5,14,35.7,44,0,29,182,6.3,2,43,226,5.3,2,6,0,8,7,77,0,2,2
colgate,2023,9/2/23,Away,syracuse,L,0,65,11,20,55,52,0,38,54,1.4,0,58,106,1.8,1,3,3,7,6,40,1,2,3
stephen-f.-austin,2023,9/2/23,Away,troy,L,30,48,18,31,58.1,136,0,28,104,3.7,2,59,240,4.1,7,7,2,16,3,35,0,1,1
incarnate-word,2023,9/2/23,Away,texas-el-paso,L,14,28,18,31,58.1,245,1,27,64,2.4,1,58,309,5.3,10,3,6,19,10,93,0,1,1
alabama-am,2023,9/2/23,Away,vanderbilt,L,13,47,18,34,52.9,143,1,33,135,4.1,0,67,278,4.1,6,8,0,14,9,50,0,1,1
murray-state,2023,9/7/23,Away,louisville,L,0,56,8,22,36.4,72,0,32,94,2.9,0,54,166,3.1,3,5,0,8,7,65,2,1,3
indiana-state,2023,9/8/23,Away,indiana,L,7,41,3,11,27.3,21,0,32,72,2.3,0,43,93,2.2,1,6,1,8,8,65,0,1,1
morgan-state,2023,9/9/23,Away,akron,L,21,24,15,33,45.5,152,3,39,79,2,0,72,231,3.2,9,6,2,17,5,51,1,2,3
delaware-state,2023,9/9/23,Away,army,L,0,57,20,34,58.8,195,0,34,24,0.7,0,68,219,3.2,10,3,3,16,6,45,2,0,2
holy-cross,2023,9/9/23,Away,boston-college,L,28,31,10,15,66.7,130,0,39,268,6.9,4,54,398,7.4,8,10,3,21,11,99,1,0,1
eastern-illinois,2023,9/9/23,Away,bowling-green-state,L,15,38,21,33,63.6,250,2,26,75,2.9,0,59,325,5.5,13,5,2,20,7,51,0,1,1
fordham,2023,9/9/23,Away,buffalo,W,40,37,23,36,63.9,309,5,43,150,3.5,0,79,459,5.8,15,8,4,27,9,63,0,0,0
southern-utah,2023,9/9/23,Away,brigham-young,L,16,41,17,33,51.5,262,1,27,84,3.1,1,60,346,5.8,12,3,1,16,5,43,1,1,2
new-hampshire,2023,9/9/23,Away,central-michigan,L,42,45,32,52,61.5,493,4,14,45,3.2,2,66,538,8.2,20,2,2,24,8,73,1,1,2
charleston-southern,2023,9/9/23,Away,clemson,L,17,66,6,16,37.5,61,0,30,12,0.4,1,46,73,1.6,3,0,1,4,2,20,0,1,1
lafayette,2023,9/9/23,Away,duke,L,7,42,9,18,50,87,1,33,126,3.8,0,51,213,4.2,6,7,1,14,6,74,0,2,2
mcneese-state,2023,9/9/23,Away,florida,L,7,49,7,14,50,66,0,26,46,1.8,1,40,112,2.8,4,2,0,6,5,34,0,0,0
eastern-washington,2023,9/9/23,Away,fresno-state,L,31,34,27,46,58.7,233,2,38,133,3.5,2,84,366,4.4,10,11,1,22,5,55,1,1,2
south-carolina-state,2023,9/9/23,Away,georgia-tech,L,13,48,10,19,52.6,95,0,42,196,4.7,2,61,291,4.8,6,7,1,14,7,29,1,1,2
eastern-kentucky,2023,9/9/23,Away,kentucky,L,17,28,19,29,65.5,219,1,27,92,3.4,1,56,311,5.6,10,4,1,15,4,37,1,1,2
northwestern-state,2023,9/9/23,Away,louisiana-tech,L,21,51,12,27,44.4,139,1,51,185,3.6,2,78,324,4.2,6,12,2,20,9,97,0,3,3
lamar,2023,9/9/23,Away,louisiana-monroe,L,14,24,19,26,73.1,190,1,36,121,3.4,1,62,311,5,9,7,1,17,2,15,0,2,2
grambling-state,2023,9/9/23,Away,louisiana-state,L,10,72,15,31,48.4,157,1,29,163,5.6,0,60,320,5.3,7,8,1,16,13,104,1,1,2
richmond,2023,9/9/23,Away,michigan-state,L,14,45,18,25,72,118,1,29,75,2.6,0,54,193,3.6,6,4,1,11,3,25,1,0,1
wagner,2023,9/9/23,Away,navy,L,0,24,18,35,51.4,143,0,32,84,2.6,0,67,227,3.4,9,3,0,12,9,65,1,1,2
idaho,2023,9/9/23,Away,nevada,W,33,6,15,21,71.4,313,2,38,150,3.9,1,59,463,7.8,9,9,0,18,3,30,1,0,1
tennessee-tech,2023,9/9/23,Away,new-mexico,L,10,56,20,36,55.6,190,1,35,98,2.8,0,71,288,4.1,9,6,4,19,12,93,2,0,2
southern-illinois,2023,9/9/23,Away,northern-illinois,W,14,11,16,24,66.7,144,0,26,73,2.8,2,50,217,4.3,6,4,2,12,6,39,0,0,0
youngstown-state,2023,9/9/23,Away,ohio-state,L,7,35,17,26,65.4,135,0,33,99,3,1,59,234,4,7,4,1,12,9,76,0,1,1
california-davis,2023,9/9/23,Away,oregon-state,L,7,55,17,30,56.7,119,1,29,47,1.6,0,59,166,2.8,5,6,1,12,4,20,1,1,2
delaware,2023,9/9/23,Away,penn-state,L,7,63,6,17,35.3,58,0,24,82,3.4,1,41,140,3.4,1,2,2,5,5,33,1,1,2
cal-poly,2023,9/9/23,Away,san-jose-state,L,3,59,13,24,54.2,74,0,33,94,2.8,0,57,168,2.9,5,5,1,11,5,50,2,1,3
southeastern-louisiana,2023,9/9/23,Away,south-alabama,L,17,35,25,36,69.4,350,1,26,62,2.4,1,62,412,6.6,15,3,2,20,7,55,1,1,2
furman,2023,9/9/23,Away,south-carolina,L,21,47,20,35,57.1,243,2,31,80,2.6,1,66,323,4.9,10,6,0,16,6,53,0,1,1
florida-am,2023,9/9/23,Away,south-florida,L,24,38,24,43,55.8,374,1,29,19,0.7,2,72,393,5.5,15,3,6,24,12,115,2,3,5
austin-peay,2023,9/9/23,Away,tennessee,L,13,30,29,41,70.7,260,1,34,79,2.3,0,75,339,4.5,8,7,4,19,9,75,1,1,2
nicholls-state,2023,9/9/23,Away,texas-christian,L,6,41,17,36,47.2,177,0,39,86,2.2,0,75,263,3.5,9,5,1,15,7,45,1,1,2
texas-southern,2023,9/9/23,Away,toledo,L,3,71,9,21,42.9,97,0,41,141,3.4,0,62,238,3.8,3,13,1,17,11,108,1,1,2
idaho-state,2023,9/9/23,Away,utah-state,L,28,78,34,53,64.2,323,3,30,101,3.4,1,83,424,5.1,18,9,1,28,0,0,1,2,3
duquesne,2023,9/9/23,Away,west-virginia,L,17,56,15,32,46.9,231,2,28,3,0.1,0,60,234,3.9,9,1,0,10,3,35,0,2,2
houston-christian,2023,9/9/23,Away,western-kentucky,L,22,52,18,29,62.1,213,2,35,155,4.4,1,64,368,5.8,11,11,2,24,8,77,2,1,3
portland-state,2023,9/9/23,Away,wyoming,L,17,31,23,39,59,254,1,40,90,2.3,1,79,344,4.4,14,6,0,20,2,15,1,1,2
albany,2023,9/10/23,Away,hawaii,L,20,31,11,32,34.4,115,0,36,124,3.4,1,68,239,3.5,7,5,3,15,6,70,1,1,2
bethune-cookman,2023,9/14/23,Away,miami-fl,L,7,48,11,17,64.7,132,0,30,33,1.1,1,47,165,3.5,6,1,1,8,6,35,1,0,1
stony-brook,2023,9/16/23,Away,arkansas-state,L,7,31,21,33,63.6,221,1,29,90,3.1,0,62,311,5,7,6,1,14,8,45,0,0,0
samford,2023,9/16/23,Away,auburn,L,13,45,19,33,57.6,144,1,28,74,2.6,1,61,218,3.6,4,7,1,12,1,5,0,2,2
indiana-state,2023,9/16/23,Away,ball-state,L,7,45,9,21,42.9,157,1,32,104,3.3,0,53,261,4.9,5,6,1,12,4,40,2,1,3
long-island,2023,9/16/23,Away,baylor,L,7,30,6,14,42.9,40,0,29,143,4.9,1,43,183,4.3,1,9,0,10,5,45,0,1,1
north-dakota,2023,9/16/23,Away,boise-state,L,18,42,17,31,54.8,142,1,34,41,1.2,2,65,183,2.8,6,5,3,14,3,37,2,0,2
idaho,2023,9/16/23,Away,california,L,17,31,27,46,58.7,269,0,26,107,4.1,2,72,376,5.2,16,3,3,22,9,82,2,1,3
duquesne,2023,9/16/23,Away,coastal-carolina,L,7,66,13,26,50,164,1,36,183,5.1,0,62,347,5.6,6,10,0,16,9,62,1,3,4
central-connecticut-state,2023,9/16/23,Away,kent-state,L,10,38,6,17,35.3,50,0,36,103,2.9,1,53,153,2.9,3,4,3,10,6,35,0,2,2
murray-state,2023,9/16/23,Away,middle-tennessee-state,L,14,35,23,32,71.9,194,1,38,207,5.4,1,70,401,5.7,8,6,2,16,6,50,3,0,3
virginia-military-institute,2023,9/16/23,Away,north-carolina-state,L,7,45,14,24,58.3,176,1,21,15,0.7,0,45,191,4.2,6,1,3,10,3,30,0,1,1
texas-southern,2023,9/16/23,Away,rice,L,7,59,9,19,47.4,104,1,31,81,2.6,0,50,185,3.7,4,3,3,10,11,94,2,0,2
prairie-view-am,2023,9/16/23,Away,southern-methodist,L,0,69,7,17,41.2,62,0,40,94,2.4,0,57,156,2.7,4,3,3,10,9,94,0,0,0
sacramento-state,2023,9/16/23,Away,stanford,W,30,23,21,33,63.6,279,1,36,169,4.7,2,69,448,6.5,12,10,1,23,6,50,0,2,2
norfolk-state,2023,9/16/23,Away,temple,L,9,41,12,22,54.5,110,1,39,130,3.3,0,61,240,3.9,5,7,3,15,4,36,0,0,0
jackson-state,2023,9/16/23,Away,texas-state,L,34,77,23,36,63.9,282,2,39,118,3,3,75,400,5.3,14,6,3,23,9,86,0,1,1
tarleton-state,2023,9/16/23,Away,texas-tech,L,3,41,24,44,54.5,197,0,36,145,4,0,80,342,4.3,13,5,1,19,5,56,0,3,3
villanova,2023,9/16/23,Away,central-florida,L,14,48,9,23,39.1,145,0,30,83,2.8,2,53,228,4.3,5,5,1,11,3,20,0,1,1
north-carolina-central,2023,9/16/23,Away,ucla,L,7,59,17,31,54.8,142,0,37,90,2.4,1,68,232,3.4,9,5,0,14,4,25,1,1,2
weber-state,2023,9/16/23,Away,utah,L,7,31,11,23,47.8,66,0,19,61,3.2,1,42,127,3,3,1,1,5,7,60,1,1,2
northern-colorado,2023,9/16/23,Away,washington-state,L,21,64,18,30,60,208,2,31,158,5.1,1,61,366,6,7,8,2,17,7,85,0,0,0
gardner-webb,2023,9/23/23,Away,east-carolina,L,0,44,8,21,38.1,30,0,40,76,1.9,0,61,106,1.7,2,7,2,11,1,15,5,0,5
delaware-state,2023,9/23/23,Away,miami-oh,L,20,62,21,34,61.8,274,3,28,77,2.8,0,62,351,5.7,9,4,1,14,8,67,0,0,0
texas-am-commerce,2023,9/23/23,Away,old-dominion,L,9,10,15,26,57.7,124,1,42,126,3,0,68,250,3.7,5,7,4,16,8,79,1,0,1
nicholls-state,2023,9/23/23,Away,tulane,L,7,36,27,39,69.2,273,1,27,62,2.3,0,66,335,5.1,14,4,3,21,7,55,0,4,4
utah-tech,2023,9/30/23,Away,colorado-state,L,20,41,21,33,63.6,185,2,35,164,4.7,0,68,349,5.1,8,7,3,18,4,45,0,1,1
abilene-christian,2023,9/30/23,Away,north-texas,L,31,45,19,38,50,217,4,33,170,5.2,0,71,387,5.5,9,9,2,20,4,33,0,1,1
wagner,2023,9/30/23,Away,rutgers,L,3,52,5,8,62.5,23,0,29,83,2.9,0,37,106,2.9,1,4,1,6,4,29,0,0,0
howard,2023,10/7/23,Away,northwestern,L,20,23,18,30,60,169,0,36,162,4.5,3,66,331,5,9,8,1,18,8,52,0,0,0
william-mary,2023,10/7/23,Away,virginia,L,13,27,14,19,73.7,72,0,39,147,3.8,1,58,219,3.8,5,9,1,15,5,58,1,0,1
merrimack,2023,11/4/23,Away,massachusetts,L,21,31,11,27,40.7,131,1,33,95,2.9,1,60,226,3.8,5,6,5,16,10,77,0,0,0
campbell,2023,11/4/23,Away,north-carolina,L,7,59,25,37,67.6,185,1,42,102,2.4,0,79,287,3.6,8,9,3,20,9,60,3,1,4
kennesaw-state,2023,11/4/23,Away,sam-houston-state,L,21,24,8,14,57.1,44,0,34,247,7.3,3,48,291,6.1,3,6,0,9,8,69,0,1,1
holy-cross,2023,11/11/23,Away,army,L,14,17,16,23,69.6,156,2,48,239,5,0,71,395,5.6,8,15,3,26,8,65,1,1,2
chattanooga,2023,11/18/23,Away,alabama,L,10,66,10,21,47.6,107,0,35,126,3.6,1,56,233,4.2,6,4,1,11,5,25,0,1,1
sacred-heart,2023,11/18/23,Away,connecticut,L,3,31,17,26,65.4,146,0,29,54,1.9,0,55,200,3.6,7,5,1,13,5,25,0,0,0
north-alabama,2023,11/18/23,Away,florida-state,L,13,58,15,30,50,83,2,34,143,4.2,0,64,226,3.5,4,6,4,14,8,75,1,1,2
abilene-christian,2023,11/18/23,Away,texas-am,L,10,38,19,34,55.9,149,0,25,93,3.7,0,59,242,4.1,9,3,0,12,7,70,0,0,0